...............................................................................................................................................................................................................................................................................................................................................................^............................................................................................................................................................................................................................^.......................................................................................................................................................................................................................................................................................................................................
........................................................................................................................................................................................................................................................^.........................................................................................######...#########.....................................................................####^^####...####...####.....................####........####....................................................................####...#####...#######........................................#####...#####...............................................................................................................................................................................................................................................................................
....................................................................................................................................................................................................................................................#########..............................................................................................................................................................................######..........................................................................................................................................###......................................................................................................................................................................................................................................................................................................................................
.........................................................................................................................................................................................................#####................................................................................................................................##..................................................................................#####....######...............................####........####...................................................................#####....................#.....######..........................####..............................................................................................................................................................................................................................................................................................
..................................................................................................................................................................................................^..........................................#####............##..............................................................................##...........................................................................................######...........................................................................................................................................#........................######^^#########..............................................................................................................................................................................................................................................................................................
.....................................................................................................................................................................######...................#########.................................................................................................................................########...........................................................................#####..........................................####..........................####.....................#####.......................#####..........................#...................######################..............................................................................................................................................................................................................................................................................................
...............................................................................................................................................................................................#######................................#####......................####.............................................................##############............................................................................................................................................................................................................................................#..............###########################..............................................................................................................................................................................................................................................................................................
............................................................................................................................................#....................##.......................##....#####.........................................................................#...#...#...#....................^............####################......................................................................###............................#......#.......####......................................####........#####........#..........^.......##................................#.........################################.............####...#####.....................................................................................................................................................................................................................................................................
.......................^..................^..................^.......^..................^^...................^^...............#.............#....................##..........^............##...............^.........#.............#.................................^^^......#...#...#...#.....^^.....^^......#.......#########################......^^.....^^.....^^...........................#...#...#...#........###............^^..............#......#.......####..................................................##...........#...^^.....#.......##........#....#....#.....^^............####################################.....^^...............###^^...................................................................................................................................................................................................................................................................
======================================================================================================================================================================================================================..============.................................=======================================================================================================..========..=====================================================..===========================................................^^^^^^^^^^===========........==========================================================================================================...........========================================================================================================================================================================================================================================================================