...............................................................................................................................................................................................................####..#####........................................###..............................####..........................................................................####............####................................................................................................................................................................................#####.........................................................................####.....................................................####..............................................................................................................................................................................................................................................................................................................................................................................................................................................................................................................................................................................................................................................................................................................................................................................................................................................................................................................................................................................................................................................................................................................................................................................................................
............................................................................................................................................................................................................##............###..................................###....##..............................................................#####...##..............................................#...............................................................................................................................######..............................................#..........................................................................................#####........................................#...........................................................................^.......................................................................................................................................................................................................................................................................................................................................................................................................................................................................................................................................................................................................................................................................................................................................................................................................................................................................................................................................................................................................................................................................................................................................
.............................................................................................................................................................................................................................###^............................##..........##......................#............^............................................................####........................##..............................................................................................................^....................................................................####..............................................................####...............................................................####...........^..................................................#######....................................................................................................................................................................................................................................................................................................................................................................................................................................................................................................................................................................................................................................................................................................................................................................................................................................................................................................................................................................................................................................................................................................................................
........................................................................................................................................................................................................###.....................######.......................................................#####.......#######...................#........................................................#.......................................................................................................................#########..........#####....................................#....................^....................................#..##...##.....................###..........#####.............................#.............##.....#######...........................................##.........##...^..............................................................................................................................................................................................................................................................................................................................................................................................................................................................................................................................................................................................................................................................................................................................................................................................................................................................................................................................................................................................................................................................................................................................
.....................................................................................................................................................................................................####..................................................##..................................................................#####...................................###..................................##....................................................................................................................................................................................######.................................................####.............................#.............................................##..................................................................#######...........................................................................................................................................................................................................................................................................................................................................................................................................................................................................................................................................................................................................................................................................................................................................................................................................................................................................................................................................................................................................................................................................................................................
.........................................................................................................................................................................................................................................................................................####.............................................................................................#......................##...........................................................................................................................................................#.........................................................#.................................................#...........................#...................##................................................##................................................................................................................................................................................................................................................................................................................................................................................................................................................................................................................................................................................................................................................................................................................................................................................................................................................................................................................................................................................................................................................................................................................................................
............................................................................................................................##...................................................................######................................###...............##.........................................................................................................##.......#####......................................####...................................................................................####.................................................................................................###............................................................#.....................................................................####...####.............................................................................................................................................................................................#...........#........................................................#####.......................................................................................................#######.............................................................................................................................................................................................................................................................................######..#.......#######............................................................................................................#######...............................................................................................................................................................................................................................................................#####.###.#....................................................................................
...................................................................................................#.........................#.....................................................................................................#...................................................................#####^................##......................................#...........#......#.................................................................................................####............######..#.........................................................#.......................................#.#...............#...............#............................#................................#................................##..............##..................##..............................######..................................................................................................................................#...........#.......................#####................................#.........................................................................######............#####^^######...........................................................................................................................................................................................................................................................................######..........#........#......#####......................................................................................................#.....#.........................................................................................#####.....................................................................^..............##...............................................................................#.....#..#####.........#...#.#...###..............######...................................
....................................................^..........#...........^.............#####....##........#...........#........#..........................................................#####.......###...##...####^...........#########...........##...................#..........#...........#####....#.............#####.................................#.........#......#..................................####.........................................^.....###...^.....#####.....#....................#....................................................^..........^...........^..........############.#...............................#...........#..........#######......................................^...........^..............##.................###..............................#...........#####.....####..........................................#....#....#....#....#....#..........................................#...........#..........#..........#...........#.........#.......................####.....#...................................^..........^..........^...............#............##################.................................#..........#.....^.....#..........^..........^..........................................................................................................................#........#........#...........#...........#...........^...........................#.....#..#............######..................................................#..........#...........^..........############.....#.....##.........#####^######........................................................####.......#####....................................................##.#########..............##..........................#.............^..........###^............########....#.....#......#...###...#...#.#....#........######.....##...................................
==================^==========^===========^_=========#==========#===========#=========###############========#===========#========#=============^^===========^^=======^^==========^^=========#####..................#####=======#####........=======^^=============^^========#==========#===========#........#=======###########=======..========^^======^^======#=========#......===========^^========^^============####....===^==========^^==========^^=========#=====###===#=====#.........#####^#####..........#=======^^=========^^=========^^==========^^=========#==========#===========#==========#............#=========^^=========^^====######===========#==========#######=====^==========^^=========^^=========#===========#========..######......................=======^^========^^=========#===========#####.....#######=====^===========^^==========^^========#____#____#____#____#____#________^___________^^^________^^_________#___________#__________#__________#_____#######_________#________^^^________######__________^^________^^__________^^_________#__________#__________#___________#####____________##################__________^____^_____^^__________#__________#_____#_____#__________#__________#_______^________^_________^^__________^___________^^___________^_________^^^_________^^__________^____________^^__________#________#________#___________#___________#___________#______#####______________________#______________________######________^________^_______^_______^^________#__________#___________#__________#________________#_____##_________#____#_____#__________^^__________^^_________^^______^^^____________####_____________######^__________^^_________^^_________^^__________##____________________######______^^_________^^_______#_____________#_____#########_____^^^____######_______________________###____________________#########_____##_______^^_________^^_____^^^_______...................................................................................................#.........................#.....................................................................................................#...................##..............................................#####^................##......................................#...........#......#.................................................................................................####............######..#.........................................................#.......................................#.#...............#...............#............................#................................#................................##..............##..................##..............................######..................................................................................................................................#...........#.......................#####................................#.........................................................................######............#####^^######...........................................................................................................................................................................................................................................................................######..........#........#......#####......................................................................................................#.....#.........................................................................................#####.....................................................................^..............##...............................................................................#.....#..#####.........#...#.#...###..............######...................................
....................................................^..........#...........^.............#####....##........#...........#........#..........................................................#####.......###...##...####^...........#########................................#..........#...........#####....#.............#####.................................#.........#......#..................................####.........................................^.....###...^.....#####.....#....................#....................................................^..........^...........^..........############.#...............................#...........#..........#######......................................^...........^..............##.................###..............................#...........#####.....####..........................................#....#....#....#....#....#..........................................#...........#..........#..........#...........#.........#.......................####.....#...................................^..........^..........^...............#............##################.................................#..........#.....^.....#..........^..........^..........................................................................................................................#........#........#...........#...........#...........^...........................#.....#..#............######..................................................#..........#...........^..........############.....#.....##.........#####^######........................................................####.......#####....................................................##.#########..............##..........................#.............^..........###^............########....#.....#......#...###...#...#.#....#........######.....##...................................
==================^==========^===========^_=========#==========#===========#=========###############========#===========#========#=============^^===========^^=======^^==========^^=========#####..................#####=======#####........=======^^=============^^========#==========#===========#........#=======###########=======..========^^======^^======#=========#......===========^^========^^============####....===^==========^^==========^^=========#=====###===#=====#.........#####^#####..........#=======^^=========^^=========^^==========^^=========#==========#===========#==========#............#=========^^=========^^====######===========#==========#######=====^==========^^=========^^=========#===========#========..######......................=======^^========^^=========#===========#####.....#######=====^===========^^==========^^========#____#____#____#____#____#________^___________^^^________^^_________#___________#__________#__________#_____#######_________#________^^^________######__________^^________^^__________^^_________#__________#__________#___________#####____________##################__________^____^_____^^__________#__________#_____#_____#__________#__________#_______^________^_________^^__________^___________^^___________^_________^^^_________^^__________^____________^^__________#________#________#___________#___________#___________#______#####______________________#______________________######________^________^_______^_______^^________#__________#___________#__________#________________#_____##_________#____#_____#__________^^__________^^_________^^______^^^____________####_____________######^__________^^_________^^_________^^__________##____________________######______^^_________^^_______#_____________#_____#########_____^^^____######_______________________###____________________#########_____##_______^^_________^^_____^^^_______
