.............................................................................................###...####^^####................................................................12###........................................................................12#####..................................C....................................####...................................................................................................................................................................................................................................................................................................................................................................................................12#.................................................................................................#####...............................................#..######...#####..###.......................................................................####.........#####...........................................................................................................###............................................................................................................................................................................................
....................................................................###^^###.............##...........####.................................................................12###........................................................................12##....................................#######...............................................................####^^####.................................................................##....................^^..............................................................##.....................###....................................................................................................................................####....................................12###.................................................................................................................................######..............................#^^#...................................................................................#................................................................................12###............................................................................................................................................................................................................................
......................................................................####.........####........................#.......................12##...###........................12###.....................................#####..............................12####..................................................12#....................#...................................####.........................................^............................................##########.............#####^^####...######.............................................#.......##......................................................................................................................................................................12#####..............................................................................................#...................................................#..................####.....###..............................................................#......................................................................................1....12##......................###..###...................................###...###.............###..###......###...###.......................####..####...###^^^###....................................................................
...........................................#####..............12##.............####............................#...###...########....12##..............................12###........................................................................12######..............................####..............12##................................................####..................................###^^#####...#######....###...###....####...............................................####...............................####..............................#####....................................########............................................................................###......................................#########........................................^^............................................................####^^^##...####....#####......................................................####..............................................................###..........................................................................12#..12####.........###........................###.............................................................................................................#####...........................................^....^.....................
............................................................12####.......................................................##.....#########............................12###..............................#########.................................12########..............................................12####..................#............................................................^^.......####.........................................####...#####...............########................................................................#...........................................^^....................^^..............................................................................##.........................................34........................#####...#########...........................................###.............#####....#...........#............12###........#####.........................................................####..###...####...####.....................................................................................12###..........................###..................................###..###...................###...........###.............###...............#..........................................##..#####...........###########...................
......................................###.................12######........................................................#........................####...........######................................#.......................................12##########...........................#..............##########...........................................###............######....12###...########.......................................................................................................................####.................................................................##########.............########...########...######....^.....^^.....####..####^^^#####...#####...................................######..............##34...........................................................................................##..............#...........#..........12###..........................34.................####.................####.......................................................^^...................................................12##.................###...................................................................###..........................................................................................##..##................................................
..........................................................................................................................#..........................................................................####.....................................12##^^^^^^^^^^...................................................................#.....................###..........................12#...........................................................12#34..............##...#####...............................................................####...###.....................####....................................................................###############...........#####...................................................................####34.............#####.......................................................#####.......##..##..............#...........#........12##..#....####........###^^###..##34..................#........................................................................############34.........................................12##..........................###........................###.......###..........................................................................#.....................................##..##..............######..............####..............
...............................#####...............######............^.......######.....##...###34.............#....#.....#....##.........................######............................................................................12##############.......................##...........####..............#.............................###...................##........12#............................#.......^.......#......#.......12#####34........#34.............................#.......^.....#.......####.........................................................##..#########...............................................................................................................###..........#####.....................######34...#####.......................................................................##..##..................#...........#......12#..#..#..................####....####34................#...##..########.............................................................##......##34.......#......^.......#.......^......12##....................................................................................................................................###.........................................##..##................................................#.......
...............^....#................................................#.......#^^^^^^^...##....####34.....#.....#....#..........##......................................................####...#####..........................#######...#...#################.......................##.....^^......................#^^^......#..........^^.......................^^^...##......12#.....................^^.......#.......#.......#......#.....12#^^^^^^^#34......###.................#......#....#.......#.....#.......................................................................................................................................................................................................###..............................................................................^.........^^..........^...####........##^^^^^^^^^^............#................12###..#..#..........................######34........^.........##^^^^^^^^^^^^...................................................................####34.....#......#.......#.......#....12##..............................................................###..........................................................................###....................................##^^^^^^^^^^^^^^^^^^^^^^^^^^^^^^^^^^^^^^^^^^^^^^^^....#.......
==========================================================================================....==========================================...======...=========..............................................................................=================..........####...====================================================================================================........============================================================================================================================............................................................................................................................................................................................................................................................................===============================================================================================..............===.........========34...===========================...................................................................===============================================================...........................................................................................................................................................=================================================================
