......................................................................................................................#####............................................................###.....................................................................................................................................................#....................................................................#####...............................................................................................................................#.....................................................########................................................................................................................................................................................^.......................................................................................................................................................................................................................................................................................................................................................................................................................................................................................................................................................................................................................................................................................................................................................................................................................................................................................................................................................................................................................................................................................................................................
..................................................................................................................###....................####.............................................#............##^^####......................................................^^..........................................................######..###...#.............................................................#####.........................................................................................................................^............#.........................................................................................................................................###.............................................................................................#####.#####.................................................................................................................................................................................................................................................................................................................................................................................................................................................................................................................................................................................................................................................................................................................................................................................................................................................................................................................................................................................................................................................................................................................................
....................................^......................................................................^........................#####.........................................###......#.....................................................................#########..........#.................................................................................................................#####...............###.............................................................#######..#####..###..###......................####............#...............................................#####..........................................................................####..###.....................................########...###..##########...............................###.............................................................................................................................................................................................................................................................................................................................................................................................................................................................................................................................................................................................................................................................................................................................................................................................................................................................................................................................................................................................................................................................................................................................................
..................................#######..........................####^^####...........................########............................................................................#.....####..............................................................................#...######.....................#####...####........................^^......................................#####.......................................................#####....................................................................########............#................................................................####................###......................................................###..###...............................................................................................###..............................................................................................................................................................................................................................................................................................................................................................................................................................................................................................................................................................................................................................................................................................................................................................................................................................................................................................................................................................................................................................................................................................................................
.........................................#...............^...^..............................................................######...........####............................###.............#................####^^####....................................####..........###########...............................................................########..................................................................###...................^^.....#...#....^^...............#####........................#....^^.......############............#..........................................#####................................#####......................................##............................................##..............................####..........##.........###.................................................................................................................................................................................................................................................................................................................................................................................................................................................................................................................................................................................................................................................................................................................................................................................................................................................................................................................................................................................................................................................................................................................................................
...............................#..........#...........###########....................................##.........................................................####..........................###..............................................................................................................####..........................#####......................................#####...................................................##########.#...#.########.........................................##########################............#..................................^^......................................#####.........###..........................###....................................^^...^^..............................................^^...................................#####..........................................................................................................................................................................................................................................................................................................................................................................................................................................................................................................................................................................................................................................................................................................................................................................................................................................................................................................................................................................................................................................................................................................................
...........................................#...................................###......................................................................######..........###..........................................................................######..............................................####.....................................................................................................................###..........................................######..........................................................####.....#.............................###########.............................####...................##...................####..................................###############..............................###......##################......................................................................................................................................................................................................................................................................................................................................................................................................................................................................................................................................................................................................................................................................................................................................................................................................................................................................................................................................................................................................................................................................................................................................................
...........................##...............###...##.....................................####....###.............................................#####............................................................................................................................................^....................#####..................................####...####...####...####......................................................#............................###...........................................................................#...............................................................................................#..............................####..###..............................................................................................................................................................................................................................................................................................................................................................................................................................................................................................................................................................................................................................................................................................................................................................................................................................................................................................................................................................................................................................................................................................................................................................................................................................................
.....................................................................................................................................................................###...............####......................................................####.........................................#########...............................................................................................................................########............................................######...######....####################.......................#......................#####......................................................................###........###..........................###.###..###...........................................###.............................###..................................................................................................................................................................................................................................................................................................................................................................................................................................................................................................................................................................................................................................................................................................................................................................................................................................................................................................................................................................................................................................................................................................................................................
........................#...........................................................###........#........................................########........................................................................#######.........................................................####.....................................^^.............................................................................................................................................................................................#.......................#.....................................................................................................................................................................................................................................................................................................................................................................................................................................................................................................................................................................................................................................................................................................................................................................................................................................................................................................................................................................................................................................................................................................................................................................................................................................................................................................................................................................................
.................................................................................................................................................................###......####...####........................................................####.............................................................................########..................................................................................#...........................................................####........................................#.......................#...............#####.....................................................................................#.............................................................................#######.......................................................................................................................................................................................................................................................................................................................................................................................................................................................................................................................................................................................................................................................................................................................................................................................................................................................................................................................................................................................................................................................................................................................................................................................
.....................#....................................................................####.....................................####....................................................................................................................................#####..####..........................................................................................................................#########.......................................................................................................#..............#........#.....................................................................................................#####...........................................................................................................................................................................................................................................................................................................................................................................................................................................................................................................................................................................................................................................................................................................................................................................................................................................................................................................................................................................................................................................................................................................................................................................................................................................................................
............................................................#..........................#####............#......#.....#......................................#####......#...........................................^......................#...........................######......................................................................................#.......#......#.........................###########..........................................##.....##......##...............................................#...........#..#........#...........##..............#####...##.........#.................................................##########.......................................................................####....................................................#......#......#.............................................................................................................................................................................................................................................................................................................................................................................................................................................................................................................................................................................................................................................................................................................................................................................................................................................................................................................................................................................................................................................................................................................................
..................#.................#....#....#....#........#...................^.......................#......#.....#.........####...........^^....^^.................#........................^^...........^.....#.............^........#.........^^.............####......................................................................#.....#.....^^.......#.......#......#.......#...#...#......##############.............^......^.......^.............##.....##......##...........^^........^^........^^.......................#..#..#.............^^.....##..................#^^^##.........#........#................^...^....^....^...^...############........^^...^^...^^...^^...^^.................................................................................................#......#......#.....^^......................................................................................................................................................................................................................................................................................................................................................................................................................................................................................................................................................................................................................................................................................................................................................................................................................................................................................................................................................................................................................................................................................................................
=============================================================...======..===========================================================..=========================================...=======...=================================================================..=====.....................................................................==================================================...=...=====================......=====================================================================================================================================================================================...===================================================================================..====..===..==..========..======....................................................==================================================================================================================================================================================================================================================================================================================================================================================================================================================================================================================================================================================================================================================================================================================================================================================================================================================================================================================================================================================================================================================================================================================================================
