.............................................................................................................................................................HH..###...................................................##........................................##......................#####..............####...............######...........................................###########......###...........................................................................................................................######.................####34...........................................................................................................................................................................................................................................................###..............................................................................................................................
..................................................................................................................HHH....................................HH......vv............................#...###...###.......34...v.....................HHHH...HHH.................................vvvvv........####......................................................................###########.......v......###..............................###...###............................................####.......................................................##34....TTTT...TTT...TTTT...T...TTTTTTTT...................................................................###........................................................................................................C...........................####.......vvv...1HHHHH..###................................................................................................................
.............................................................................................................HHH.....................................HH...............####.......TTTT...........................C..##34....HHHHH...........................TTTT......###...##....######.................................#####...............................######...##...###...vvvvvvvvvvv..............vvv................HHHH............................................................................###...###.......#..........#.......#####........##34.............................................................................................................................#34.............................................................................####...........................vvvv...1H4.....12#....#.........................................................####...####.................................................
..............................................................................HHH...###.................HHH...........HHH........................HH.............#####.......................#.................###....##34.............1..HHH.....................................vvvvvv........#####.......................................^.......^^.......................................12TTT3H2TTT............................#####....................................###34.C.12#..####.................................................................##34...................................TTTTT........................................................#........####..............###34......................................................................................##...#######.............12H#H34.12###TTTT#..............................12..HH...HHHHH.........................................................................
.........................................................................HHH........vvv...HHH4.....HHH.......................................HH............................####........................................##...........12#........................................................vvv................####.................###################................................12##...#H#..........####^^^#####.......................................................#T#.................#####.............###................###...................##34...................................................................................................................####..............HHHHH..TTT..............................1H...HHH................##.................................HHHH2HHH#HHH#HHHH#HHHH#.......####.................12##.....................##..............................................................
....................................................................HHH......................#34..................^........HH............HH................###.........................###........................................12#...................................................................................................................................................12##.....#H#.............#####..................................................##.......#T#..............................................................................##34.......................................TTTTT............................................##......................................1........................................12#.......HHHHH...^.................###......................#...#...#...#....#....#..........................12####.....................................................................................
.............................................................................................####............12#####34...............HH..........................................................................................................................##...................................................................................................................12####.....#H#.............................................................................#T#................................................................................##34..........................................................................................................###...............12#.............HHHHHHHH.................12###............TTTTTTTTT...............................HHHH..#HHH#HHH#HHH#HHHH#HHHH#........................12######...............TTTT..................................................................
..............................................................HHHH............#.......^....................12#########34.......HHHH..vv..........#....###...................................##...##34................#34.......^......^....1..####...###.............................12...##34.....#.....#.....#.....#......#...#TTT#......#.............#.......##...#.....#34.....12##.........#H#...................................................#####...#######...........#T#..................................................................................##34...........................................TTT...TTT...TT...TTT...TTTT..TTT...TTTT............................................................................HHH.................................................................#...#...#...#....#....#.............34.......12########.............................................##......#......^..........#.............
..................^..................^^.......^^......^^......................#.......#..................12#############34..................^....#................^^....^.....^^....^.......##...####34..^......^^...###34.....#......#..12#...............TTTT......###...##......12##^^^####34...#.....#.....#.....#......#...#...#......#.......^^....#.......#....#.....###3HHH2####.........#H#.............................................................................#T#....................................................................................##34...................................................................................................................................................TTTTTT.......................................................................#HHH#HHH#HHH#HHHH#HHHH#.............##34...12##########^^^^^^^^^^^^^^^^^^^^^^^^^^^^^^^^^^^^^^^......##......#......#..........#.............
==============================================================================================================================================================================================...===========================================.....................................============================================...=...==============================....==================.........===.............................................................................===......................................................................................##34..............................................................................................................................................................................................................................=...=...=...=....=....=.............####3H2############=====================================================================================
