................................................................................................................................................................................................................................................................................................................................C...............................................................................................................................................................................................................................................................................................................................
...................................................................................................................................................................###^^###34..................................................###...........................................................###^^###...##...###34...........####...............................................................................................................................................................................................................................................................................................................................
................................................................................................#######.....................#########34..............................####..##34........................................######..................................................................####.............##34............................................................................................................................................................................................................................................................................................................................................
.......................................................................................................................................34.....................###..........####34....................12##.....^....................####.................................................###.....................####34...##.....................................................................................................................................................................................................................................................................................................................................
..............................................................................####...###..####..........####.............#...............34................................######34................12#.....##########..............................................................###..........................................................................................................................................................................................................................................................................................................................................................................
..........................................................................12..####.........................................................##..########...##...............########34............12###..................................###34...................................................................................................................................................................................................................................................................................................................................................................................................................
........................................................................12##..####...........................##########....................................................##########..........12#####.....................................##34............................######...............................................................................................................................................................................................................................................................................................................................................................................
.....................................................#.......#........12####..####.........................................................................................##########..........#######.....................................####34......#....#....#.....##............#...............12###......................................................................................................................................................................................................................................................................................................................................................
.............^.......^............^......#...........#.......#......12######..####.........................................................................................##########....^^....#######.....................................######34....#....#....#.....##............#...###....^..12#####....4...........^.....^...............................................................................................................................................................................................................................................................................................................................
==================================================================================.........................................................................................===========================.....................................===============================================================....==================================================================================================================================================================================================================================================================================================================================================
