................................................................................................................................................................................................................................................................................................................................C...............................................................................................................................................................................................................................................................................................................................
...................................................................................................................................................................###^^###◣...................................................###...........................................................###^^###...##...###◣............####...............................................................................................................................................................................................................................................................................................................................
................................................................................................#######.....................#########◣...............................####..#◣..........................................######..................................................................####..............◣..............................................................................................................................................................................................................................................................................................................................................
......................................................................................................................................◣.......................###..........##◣.......................◢###.....^....................####.................................................###.......................◣......##.....................................................................................................................................................................................................................................................................................................................................
..........................................................................◢#..####...###..####..........####.............#.............◣...................................###◣.....................◢#.....##########..............................................................###.............................◣............................................................................................................................................................................................................................................................................................................................................
.........................................................................◢##..####......................................................◣......########...##...............####◣...................◢##..................................####◣.......................................................................####........................................................................................................................................................................................................................................................................................................................................
........................................................................◢###..####...........................##########..................◣.................................#####◣.................◢###......................................#◣.............................######...............................................................................................................................................................................................................................................................................................................................................................................
.....................................................#.......#.........◢####..####........................................................###..............................######◣...............◢####......................................##◣........#....#....#.....##............#................◢###......................................................................................................................................................................................................................................................................................................................................................
.............^.......^............^......#...........#.......#........◢#####..####.........................................................................................#######◣......^^.....◢#####......................................###◣..#....#....#....#.....##............#...###....^....◢####....◣...........^.....^...............................................................................................................................................................................................................................................................................................................................
==================================================================================.........................................................................................===========================......................................==============================================================....==================================================================================================================================================================================================================================================================================================================================================
