....................................................................................................................................................................................................................................................................................................................................................................................................................................................................................................................................................................................................................................................................................................................................................................................................................................................................................................................................
....................................................................................................................................................................................................................................................................................................................................................................................................................................................................................................................................................................................................................................................................................................................................................................................................................................................................................................................................
....................................................................................................................................................................................................................................................................................................................................................................................................................................................................................................................................................................#...............................................................................................................................................................................................................................................................................................................................................................
.............................................................####.............#....................................................................................................................................................................................................................................................................................................................................................................................................................................................................................#####....................................########................................................................................................................................................................................................................................................................................................................
............................................................#####............##........................................#.......................................................................................................................................................................................................................................................................................................................................................................................................................................................................................................................................................................................................................................................#####...#########....................................................................................................................................
......................................................................................................................#####...............................................................................................................................................................................................................................................................................................................................................................................................................................................#.....................##########...........##########..#########...######.................####..############..######...................................######.............................................................................................................................................................................................
.....................................................^^..................................................................................................................................................................................................................................................................................................................................................................................................................................................................................................................######....................................................................###############.....................................................................................................######.......................................................#####...........................................................................................
...............................#####...............######.............................................................................................................................................................................................................................................................................................................................................................................................................................................................................................................................#########............................................................................................................................#####..................................####..............................................................................................................................................................
....................................................................................................................................................................................................................................................................................................................................................................................................................................................................................................................................................................................................................................................................................................................................................................................................................................................................................................................................
====================================================================================================================================================================================================================================================================================================================================================================================================================================================================================================================================================================================================================================================================================================================================================================================================================================================================================================================================