.................................................................................................................................................................................................................................................................................................#...###...#....#....#....####..........................................###.......................................................................................####...####....................................###34.............................................................................................................#####...................#........#.........................................................................^^^^^^............................................................................................................................................................................................................................................................................................................................................................................................................................................................................................
.......................................................................................................................................................................................................................................................^^..C...............................####......................................................................#...................###................12#...................................................#..#...#..#......................................###34........................................................................................................#..........................#........#..............................................................^^^^^....^^######................H....H....H.................................................................................................................................................................................................................................................................................................................................................................................................................................................................
...................................................................................................................................................................................................................................................#########...........................12..........................................................................................####..#.....###........12###..........................###34.................#..#..#...#..#.................................#....#####34.............##..................................................................###....#....#....#####..........................#........#..............................................^^^^^..........^#####^^^^##...............HHHH...............................................................................................................................................................................................................................................................................................................................................................................................................................................................................
.......................................................................................................................................................................................###........................#####34............................................................12##......................................................................####...................#..#..............12#####.........................^#..##34..................#..#...#..#......................................#######.............##..............................................................12..................................................####.....#.........###...#...###........................#####^^......^^##########...12###HHHHHHH.....................................................................................................................................................................................................................................................................................................................................................................................................................................................................................
.......................................................................................................................................................................................................................##34..................####.............#....................12####...................................................................................#####.....#..#............12#######...................########..####34.......####.....#..#...#..#..............................#.......#######.......12##..##............................................................12##.....................................................#.....#.....12........................................######^^..^^##...........12#####......#.......................34............................................................................................................................................................................................................................................................................................................................................................................................................................................................
............................................................................................................................................................................#########.......####...#####...#####........###34................................................############........................................#####34..................###...........##..#...#.....#..#......###...#########...................................................#..#...#..#......................................#######.....12####..##..........................................................12####....................................34...............#######...12##................###......................#######^^##...12##34..12##..###......#.......................##34..........................................................................................................................................................................................................................................................................................................................................................................................................................................................
..........................................................................................................................................................................................................................###34....^^.....###....................#...........#..........#............................................###34..........................##......#^^^#.....#.......................#..............###.....................##...........#..#...#..#...........................#..........#######...12######..##..##34..............................................................................................##34.....................12####.............................C..................##...12######32##....###......#.........................##34........................................................................................................................................................................................................................................................................................................................................................................................................................................................
.......................................................................#...............#..........^........................................................^.............#...............#..................................#################.....##......##..............#..#..........#............................................#####34......#...##....................#####.....#.....###...............#..........#........................##.##...........#..#...#..#......................................#######...########..##..####34.....#.........................................#............................................####34........#########32######......................####...######....######34....12##......##......###......#...........................##34......................................................................................................................................................................................................................................................................................................................................................................................................................................................
...............^.........................^.............................#...............#..........#.........................^....^..................^......#.............#...............#........................................................##......##........#.....#..#..........#^^^^^^^^^^^^^^^^^^^^^^^^^^^^^^^^^^^^^^^^^^^^#######34....#....#........##............................................#^^^^......#...........#####........##..............#..#...#..#.....C.....^^....^^.....#^^^^^^^^^^^^^#######...########..##..######34...#.....^......^......^......^......^.......#............................................######34......#^^^^^^^^^^^^^^^^^^^^^^^^^^^^^^^^^^^^^^^^^^^^^##...........#####3412####......##......###......#.............................##34....................................................................................................................................................................................................................................................................................................................................................................................................................................................
============================================================================================================================================================================================.................................................=================================..........===========================================================....======================================.................================================^^====..............#..#...#..#.....========================================...========..##..======================================================............................................==============================================================...........=============......==......===......=.............................========================================================================================================================================================================================================================================================================================================================================================================================================================================================
