........................................................................................................................................................................................................................................................................................................................................................^.......................................................................................................................................................................................................................................................................................................
........................................................................................................................................................................................................................................................................................................................................................#.......................................................................................................................................................................................................................................................................................................
.............................................................................12TT...T......................................#####..............................................................................................................................................TTT.......................................................................#.......................................................................................................................................................................................................................................................................................................
.............................................TTTT...HHH....................12Tv........................................................................................................................................................................................................................................................HHHH.............#.......................................................................................................................................................................................................................................................................................................
....................................................vvv..................12Tv..........HHHH...HHHHHHH...................#.........#.................................................########...................................................................12TTTT..TTTTT............................................................................#.......................................................................................................................................................................................................................................................................................................
..........................................T..............H.............12Tv............................................................................................................vv....................................................................12T#...............................................................HHHHH...................#.......................................................................................................................................................................................................................................................................................................
...................................................................####Tv............................................#...............#....................................###..###.........................................................................12T..#.............................................................................HHHHHHH...#.......................................................................................................................................................................................................................................................................................................
.......................................T....................HHHHH..........................................................................................................v....v........................................................................12T....#......................................................HHHHHHH..........................#.......................................................................................................................................................................................................................................................................................................
.................................................................................................................##.....................#..........................#####........................4....1.................................................12T......#...............................................................................................................................................................................................................................................................................................................................................................................................
....................................T......................................................................HHHH.....................................................vvv.........................######...............................................12T......^^#^^...........########......................TTTTTTTT............................................................................................................................................................................................................................................................................................................................................
...........................................................................................................................................###...####...####..###.................................vv...............................................12T........#####...........vvvvvvvv...................................................HHHHHH.........34......................................................................................................................................................................................................................................................................................................
.................................T.................................####................................HH.........................................vv.....vv....v.................................................................................12T..........vvvvv.......................TTTTTT...TTTTTTT..............................................##34....................................................................................................................................................................................................................................................................................................
...............................................................................................................................................................................................................................................12T....................................................................................H.................####34..................................................................................................................................................................................................................................................................................................
..............................T..............................................................HH...HHH........................................................................................................................................12T........................................................................................................######34................................................................................................................................................................................................................................................................................................
..........................................................................####...............vv............................................................................................................................................12##...######...........................................................................H....................#########3...1..........................................................................................................................................................................................................................................................................................
...........................T.......................................####...vvvv.........HHHH...................................HHHHH...HHHHHHH........................................................................................HHHH..####...vvvvvv......HHHHH................................................................................................12#..........................................................................................................................................................................................................................................................................................
................................................1...............1.....#................vvvv.....................................................HHHHH......................................................................................#vv#...............TTTTT.............................................................H.................###############32###..........................................................................................................................................................................................................................................................................................
........................T.....................12#.............12#.....#.........#####......................................H......................................................................12...34.........................H........#..#...^....^................................................................................................#.......................................................................................................................................................................................................................................................................................................
.....................................TTTT...12###...........12###.....#.........vvvvv...........................................................................................................12##...T#34................................#..#...#....#......................................TTTTT#TH.......................H..........................#.......................................................................................................................................................................................................................................................................................................
.....................T..........1HH.........vvvvv...34....12#####.....#.................................................H.....................................................................12####....TT#34..................H...........#..#....................................................#THTH................................................#.......................................................................................................................................................................................................................................................................................................
..............................12#vv.................##34..............#.......................................................................................................................vvvvvv......TT#3.............................#..#.........................................TTTT.......#THTHTH................H.............................#.......................................................................................................................................................................................................................................................................................................
..................T.........12###...................####34............#..............................................H...................................................................HHH................TT...........HHHH..............#..#....................................................#THTHTHTH....................................................................................................................................................................................................................................................................................................................................................
..........................12#####...................######34..........#.................................1H4.1H4..........................................##34..............................................................................#..#...#....#......#####...........########.............#THTHTHTHTH.........#.....^......^.....^.............#.......................................................................................................................................................................................................................................................................................................
...............#........12#######...................vvvvvvvv..........#^^^^^^^^^^^^^^^^^^^^^^^^^^^^^^#############^.....^......^......^.....^.......^....####34...........TTT...TT..TTT..........................HHHHHH............^..............#....#.....^#...#^..........#^^^^^^#.............#THTHTHTHTHTH.......#.....#......#.....#.............#.....^...^.............................................................................................................................................................................................................................................................................................
=================================.....................................=========================================================================================...======...........................................============================================...====================.............=============================================================================================================================================================================================================================================================================================================================================================
