................................................................................................................................................................................................................................................................................................................................................................................................................................................................................................................................................................................................................................................................
................................................................................................................................................................................................................................................................................................................................................................................................................................................................................................................................................................................................................................................................
.............................................................................12TT...T......................................#####................................................................................................................................................................................................................................................................................................................................................................................................................................................................................................................................
.............................................TTTT...HHH....................12Tv.................................................................................................................................................................................................................................................................................................................................................................................................................................................................................................................................................................................
....................................................vvv..................12Tv..........HHHH...HHHHHHH...................#.........#.................................................########....................................................................................................................................................................................................................................................................................................................................................................................................................................................................
..........................................T..............H.............12Tv.....................................................................................................................................................................................................................................................................................................................................................................................................................................................................................................................................................................................
...................................................................####Tv............................................#...............#....................................###..###..............................................................................................................................................................................................................................................................................................................................................................................................................................................................................
.......................................T....................HHHHH...............................................................................................................................................................................................................................................................................................................................................................................................................................................................................................................................................................................................
.................................................................................................................##.....................#..........................#####........................4....1..........................................................................................................................................................................................................................................................................................................................................................................................................................................................
....................................T......................................................................HHHH.................................................................................######..........................................................................................................................................................................................................................................................................................................................................................................................................................................................
...........................................................................................................................................###...####...####..###.................................vv............................................................................................................................................................................................................................................................................................................................................................................................................................................................
.................................T.................................####................................HH.......................................................................................................................................................................................................................................................................................................................................................................................................................................................................................................................................................
................................................................................................................................................................................................................................................................................................................................................................................................................................................................................................................................................................................................................................................................
..............................T..............................................................HH...HHH...........................................................................................................................................................................................................................................................................................................................................................................................................................................................................................................................................................
..........................................................................####...............vv.................................................................................................................................................................................................................................................................................................................................................................................................................................................................................................................................................................
...........................T.......................................####...vvvv.........HHHH...................................HHHHH...HHHHHHH...................................................................................................................................................................................................................................................................................................................................................................................................................................................................................................................
................................................1...............1.....#................vvvv.....................................................HHHHH...........................................................................................................................................................................................................................................................................................................................................................................................................................................................................................................
........................T.....................12#.............12#.....#.........#####......................................H....................................................................................................................................................................................................................................................................................................................................................................................................................................................................................................................................
.....................................TTTT...12###...........12###.....#.........vvvvv...........................................................................................................................................................................................................................................................................................................................................................................................................................................................................................................................................................................
.....................T..........1HH.........vvvvv...34....12#####.....#.................................................H.......................................................................................................................................................................................................................................................................................................................................................................................................................................................................................................................................
..............................12#vv.................##34..............#.........................................................................................................................................................................................................................................................................................................................................................................................................................................................................................................................................................................................
..................T.........12###...................####34............#..............................................H..........................................................................................................................................................................................................................................................................................................................................................................................................................................................................................................................................
..........................12#####...................######34..........#.................................1H4.1H4..........................................##34...................................................................................................................................................................................................................................................................................................................................................................................................................................................................................................
...............#........12#######...................vvvvvvvv..........#^^^^^^^^^^^^^^^^^^^^^^^^^^^^^^#############^.....^......^......^.....^.......^....####34.................................................................................................................................................................................................................................................................................................................................................................................................................................................................................................
=================================.....................................=========================================================================================....................................................=============================================================================================================================================================================================================================================================================================================================================================================================================================================
