......................................................................................................................#####............................................................###.....................................................................................................................................................#....................................................................#####...............................................................................................................................#..................................................####...####................................................................................................................................................................................^.......................................................................................................................................................................................................................................................................................................................................................................................................................................................................................................................................................................................................................................................................................................................................................................................................................................................................................................................................................................................................................................................................................................................................
..................................................................................................................###....................####.............................................#.............#^^####......................................................^^........................................................###..###..###...#.............................................................#####.........................................................................................................................^............#.........................................................................................................................................###.............................................................................................#####..####.................................................................................................................................................................................................................................................................................................................................................................................................................................................................................................................................................................................................................................................................................................................................................................................................................................................................................................................................................................................................................................................................................................................................
....................................^......................................................................^........................#####.........................................###......#.....................................................................#########..........#.................................................................................................................#####...............###............................................................###..###..#####..###..###.....................#####............#..............................................##..............................................................................####..###.....................................##..####...##...#######..#...............................###.............................................................................................................................................................................................................................................................................................................................................................................................................................................................................................................................................................................................................................................................................................................................................................................................................................................................................................................................................................................................................................................................................................................................................
..................................#######..........................####^^####...........................########............................................................................#......###..............................................................................#...######.......................###...##..........................^^......................................#####.......................................................#####....................................................................########............#................................................................####................###......................................................###..###...............................................................................................##...............................................................................................................................................................................................................................................................................................................................................................................................................................................................................................................................................................................................................................................................................................................................................................................................................................................................................................................................................................................................................................................................................................................................
.........................................#...............^...^..............................................................######...........####............................###.............#................####^^####..............................###...###...........###########.............................#.................................########..................................................................###...................^^.....#...#....^^..............###...........................#....^^........###########............#..........................................##...................................###........................................##............................................##..............................####..........##.........##..................................................................................................................................................................................................................................................................................................................................................................................................................................................................................................................................................................................................................................................................................................................................................................................................................................................................................................................................................................................................................................................................................................................................................
...............................#..........#...........###########....................................#........................................................................................###..............................................................................................................#.............................#####......................................#####...................................................##########.#...#.########.........................................##########################............#..................................^^......................................###...........###..........................###....................................^^...^^..............................................^^...................................###............................................................................................................................................................................................................................................................................................................................................................................................................................................................................................................................................................................................................................................................................................................................................................................................................................................................................................................................................................................................................................................................................................................................
...........................................#...................................###.......................................................................................##........................................................................#.....................................................####.....................................................................................................................###..........................................###.............................................................####.....#.............................###########.............................####...................##...................##....................................###############..............................###......##################......................................................................................................................................................................................................................................................................................................................................................................................................................................................................................................................................................................................................................................................................................................................................................................................................................................................................................................................................................................................................................................................................................................................................................
...........................##...............###...##.............................................##..............................................#####.............................................................................................#..............................................^....................#####..................................####...####...####...####......................................................#............................###...........................................................................#...............................................................................................#..............................####..###..............................................................................................................................................................................................................................................................................................................................................................................................................................................................................................................................................................................................................................................................................................................................................................................................................................................................................................................................................................................................................................................................................................................................................................................................................................................
......................................................................................................................................................................#................####.....................................................####..........................................#########...............................................................................................................................########............................................######...######....####################.......................#......................#####......................................................................###........###..........................###.###..###...........................................###.............................###..................................................................................................................................................................................................................................................................................................................................................................................................................................................................................................................................................................................................................................................................................................................................................................................................................................................................................................................................................................................................................................................................................................................................................
........................#...........................................................###.......#.........................................########........................................................................#######.........................................................####.....................................^^.............................................................................................................................................................................................#.......................#.....................................................................................................................................................................................................................................................................................................................................................................................................................................................................................................................................................................................................................................................................................................................................................................................................................................................................................................................................................................................................................................................................................................................................................................................................................................................................................................................................................................................
.................................................................................................................................................................###......####...####........................................................#................................................................................########..................................................................................#...........................................................####........................................#.......................#...............#####.....................................................................................#.............................................................................#######.......................................................................................................................................................................................................................................................................................................................................................................................................................................................................................................................................................................................................................................................................................................................................................................................................................................................................................................................................................................................................................................................................................................................................................................................
.....................#.....................................................................#.........................................#.....................................................................................................................................#####..####..........................................................................................................................#########.......................................................................................................#..............#........#.....................................................................................................#####...........................................................................................................................................................................................................................................................................................................................................................................................................................................................................................................................................................................................................................................................................................................................................................................................................................................................................................................................................................................................................................................................................................................................................................................................................................................................................
............................................................#...........................................#......#.....#........................................###......#...........................................^......................#...........................######......................................................................................#.......#......#.........................###########..........................................##.....##......##...............................................#...........#..#........#...........##..............#####...##.........#.................................................##########.......................................................................####....................................................#......#......#.............................................................................................................................................................................................................................................................................................................................................................................................................................................................................................................................................................................................................................................................................................................................................................................................................................................................................................................................................................................................................................................................................................................................
..................#.................#....#....#....#........#...................^.......#...............#......#.....#............#...........^^....^^.................#........................^^...........^.....#.............^........#.........^^.............####......................................................................#.....#.....^^.......#.......#......#.......#...#...#......##############.............^......^.......^.............##.....##......##...........^^........^^........^^.......................#..#..#.............^^.....##..................#^^^##.........#........#................^...^....^....^...^...############........^^...^^...^^...^^...^^.................................................................................................#......#......#.....^^......................................................................................................................................................................................................................................................................................................................................................................................................................................................................................................................................................................................................................................................................................................................................................................................................................................................................................................................................................................................................................................................................................................................
=============================================================...======..===========================================================..=========================================...=======...=================================================================..=====.....................................................................==================================================...=...=====================......=====================================================================================================================================================================================...===================================================================================..====..===..==..========..======....................................................==================================================================================================================================================================================================================================================================================================================================================================================================================================================================================================================================================================================================================================================================================================================================================================================================================================================================================================================================================================================================================================================================================================================================================
