................................................................................................................................................................................................................................................................................................................................C..............................12#34......................................................................................................................................###.................####..................................................................................####........................................
...................................................................................................................................................................###^^###34..................................................###...........................................................###^^###...##...###34...........####............................#########......######...#######....1........###..###.......12###...####............................................................................................................................................................................................................................
................................................................................................#######.....................#########34............................##########34........................................######..................................................................####.............##34..................#.......................................................12#.....................12###............................................###...........................###.................###....................................................................................##........###...................................
.....................................................................................................................................##34.....................###..........####34....................12##.....^.....................###.................................................###.....................####34...##........#######34...........####.............##..................12###..####............#######..............####......................###........34................................###...##................................................................##.......####............................................................
..............................................................................####...###..####...........###.............#...........####34................................######34................12#.....##########..............................................................###...................................................###34............................................12#####............................................................................##34.................#..............................#...#34................####...###^^####....................................##.................##...............................
..........................................................................12..####...................................................########..########...##...............########..............12###...................................##34............................................................................................######...###...................................12#######............................................................###.............####34..............................................#....##34.......................####.............###......###..................................................................
........................................................................12##^^####............................#########....................................................########............12#####.....................................##34.............................#####.....................................................................................................12#########............................................................................######..........12#...........................####..#.....###.........12#.................................................###.........................###..........................
.....................................................#.......#........12##########.........................................................................................########............#######.....................................####34......#....#....#...................#...............12###...........................##34...........................................12###########..............................................#####...####..................######........12###.......................##.....#..#......##.......12###.....................#####.........................#.............................34.......#....#.....#....
.............^.......^............^......#...........#.......#......12############.........................................................................................########^^^.........#######.....................................######34....#....#....#.....##............#....##....^..12#####....4...........^.....^....####34...14....14....14.......^.....^........12#############............................................................................######................^....^....^....^....##^^^^^#^^#.......#^^^^^#######^^^^^^^^^^^^^^^^^^^^^^^^^^^^^^^^^^^^^^^^^^^^^^^^^^^#.............................##.......#....#.....#....
==================================================================================.........................................................................................===========================.....................................===============================================================....===================================================================================............................................................................======....===========================================.......=================================================================.............................=========================
